1111111111111
1P01C10C000E1
11000CCCC0100
1100000000101
1100000000101
1111111111111





