111111111111111111111111
1000P00000000000000000001
100011100001100000C00001
100000000000000000000001
111111111111111110E00001
111111111111111111111111
