1111111111111111
1P00011000010001
1100100011000001
1000011C01110001
1110000000000101
1111111111111111
