1111111111111
1000110010011
1C01100110001
1000000000001
1100110001001
1000000000E01
1111111111111
