111111111111111111111
1P0001111000000100101
100100110000110001101
100000001100001000001
1000000000000000E0011
111111111111111111111
