11111111111111
10000000010001
10000000010001
10000000010001
100P0000010001
10000000010001
100C0000010001
100C0000010001
100C0000010001
11100000010001
1E100000010001
11111111111111
