111111111
100P10011
1100000100
1C0000001
100100E01
111111111
